[
    "1", "-", "-", "-", "-", "-", "-", "-", "-", "-", "2",
    "|", "p", ".", ".", ".", ".", ".", ".", ".", "p", "|",
    "|", ".", "b", ".", "[", "7", "]", ".", "b", ".", "|",
    "|", ".", ".", ".", ".", "_", ".", ".", ".", ".", "|",
    "|", ".", "[", "]", ".", ".", ".", "[", "]", ".", "|",
    "|", ".", ".", ".", ".", "^", ".", ".", ".", ".", "|",
    "|", ".", "b", ".", "[", "+", "]", ".", "b", ".", "|",
    "|", ".", ".", ".", ".", "_", ".", ".", ".", ".", "|",
    "|", ".", "[", "]", " ", " ", " ", "[", "]", ".", "|",
    "|", ".", ".", ".", ".", "^", ".", ".", ".", ".", "|",
    "|", ".", "b", ".", "[", "5", "]", ".", "b", ".", "|",
    "|", "p", ".", ".", ".", ".", ".", ".", ".", "p", "|",
    "4", "-", "-", "-", "-", "-", "-", "-", "-", "-", "3"
]